NO ./img/n_texture.xpm
SO ./img/s_texture.xpm
WE ./img/w_texture.xpm
EA ./img/e_texture.xpm

F 220,100,0
C 10,0,110

     11111111111111111111
11111000000        000000111111
10000000001000000000000000001
10100101001001000010000010111
10100100101010110010000000001
10000000000000000000000000101
10000000000000000000000000101
10000000000000110000000000101
10000000000000000000000000101
10000000000000000000000000101
10011000000000000000000000101
10000000000000000000000000101
10000000000000000000000000101
11111111111111111111111111111
1
1
1
1
1
1111111111111111111111111
