
SO ./img/Brick_Wall_Cracked.xpm
WE ./img/Rocky_Road_64x64.xpm
EA ./img/Dirty_Mossy_Tiles_64x64.xpm
NO ./img/Brick_Wall.xpm


F 250,100,0
C 10,0,110



   1111111111111111111111111
    1111111111111111111111111
    1000000000000000000000001
    10000000000S0000000000001
    1000000000000000000000001
    1000000000000000000000001
    1000000000000000000000001
    1000000000000000000000001
    1000000000000000000000001
    1000000000000000000000001
    1000000000000000000000001
    1000000000000000000000001
    1000000000000000000000001
    1111111111111111111111111
