NO ./img/Brick_Wall.xpm
SO ./img/Brick_Wall_Cracked.xpm
WE ./img/Rocky_Road_64x64.xpm
EA ./img/Dirty_Mossy_Tiles_64x64.xpm


F 250,100,0
C 10,0,110


1111111111111111111111111111111
1000001000000000001001000000001
1111001111111111001001111001001
1000000001000001000000000001001
1111111001001111001111001111111
1001000001000000000001000000001
1001111001111001111001001100001
1000000001000001001001001000001
1111111001111111001111001111001
1000000000001000001001001000001
1001001111111001111001001111111
1001001000001000001000000001001
1001001111001111001111111001001
100100000000000100000000N001001
1111111111111001001111111001001
1000000000000000000001000000001
1111111111111111111111111111111