NO ./img/Brick_Wall.xpm
SO ./img/Brick_Wall_Cracked.xpm
WE ./img/Rocky_Road_64x64.xpm
EA ./img/Dirty_Mossy_Tiles_64x64.xpm


F 300,100,0
C 10,0,110

        1111111111001111111111111
        1000000000110000000000001
       0110000011100000000000011
        1001000000000000000000001
111111111111111111110111111111111
100000000011000001110111111111111
11110111111111011100000010001
11110111111111011101010010101
11000000110101011100000010101
10000000000000001100000000101
10000000000000000001010000101
1100000101010101111101111N10111
11110111 1110101 101111010001
11111111 1111111 111111111111
11110111 1110101 101111010001
11111111 1111111 111111111111
11110111 1110101 101111010001
11111111 1111111 111111111111
11111111 1111111 111111111111