NO ./img/Brick_Wall.xpm
SO ./img/Brick_Wall_Cracked.xpm
WE ./img/Rocky_Road_64x64.xpm
EA ./img/Dirty_Mossy_Tiles_64x64.xpm


F 25X,1XX,X
C 1X,X,11X

        1111111111XX1111111111111
        1XXXXXXXXX11XXXXXXXXXXXX1
       X11XXXXX111XXXXXXXXXXXX11
        1XX1XXXXXXXXXXXXXXXXXXXX1
11111111111111111111X111111111111
1XXXXXXXXX11XXXXX111X111111111111
1111X111111111X111XXXXXX1XXX1
1111X111111111X111X1X1XX1X1X1
11XXXXXX11X1X1X111XXXXXX1X1X1
1XXXXXXXXXXXXXXX11XXXXXXXX1X1
1XXXXXXXXXXXXXXXXXX1X1XXXX1X1
11XXXXX1X1X1X1X11111X1111N1X111
1111X111 111X1X1 1X1111X1XXX1
11111111 1111111 111111111111
1111X111 111X1X1 1X1111X1XXX1
11111111 1111111 111111111111
1111X111 111X1X1 1X1111X1XXX1
11111111 1111111 111111111111
11111111 1111111 111111111111